testmap,12,16
20,10,19,19,19,18,18,19,19,17,21,21,19,17,21,21
22,11,10,10,10,10,10,10,11,11,10,22,19,17,21,21
21,10,10,10,10,10,10,11,11,11,10,21,19,17,21,21
22,10,11,12,11,10,10,10,10,11,10,21,19,17,21,21
20,10,11,14,11,10,10,10,10,10,11,20,19,17,21,21
20,10,19,19,19,18,18,19,19,17,21,21,19,17,21,21
22,11,10,10,10,10,10,10,11,11,10,22,19,17,21,21
21,10,10,10,10,10,10,11,11,11,10,21,19,17,21,21
22,10,11,12,11,10,10,10,10,11,10,21,19,17,21,21
20,10,11,14,11,10,10,10,10,10,11,20,19,17,21,21
20,10,19,19,19,18,18,19,19,17,21,21,19,17,21,21
20,10,11,14,11,10,10,10,10,10,11,20,19,17,21,21