testmap,12,16
20,19,20,21,21,19,19,20,19,19,20,19,19,19,22,22
22,10,10,12,12,10,10,16,15,17,18,17,10,10,11,21
21,10,10,12,12,10,10,16,15,17,18,17,10,10,11,21
22,10,10,12,12,10,10,16,15,17,18,17,10,10,11,21
20,10,10,12,12,10,10,16,15,17,18,17,10,10,11,21
20,10,10,12,12,10,10,16,15,17,18,17,10,10,11,21
22,10,10,12,12,10,10,16,15,17,18,17,10,10,11,21
21,10,10,12,12,10,10,16,15,17,18,17,10,10,11,21
22,10,10,12,12,10,10,16,15,17,18,17,10,10,11,21
20,10,10,12,12,10,10,16,15,17,18,17,10,10,11,21
20,10,10,12,12,10,10,16,15,17,18,17,10,10,11,21
20,19,20,21,21,19,19,20,19,19,20,19,19,19,22,22